AAAAAAAAAAAAAAA
AB           BA
ABDDCCCCCCCCCBA
AB           BA
AB           BA
AB           BA
AB           BA
AB           BA
AAAAAAAAAAAAAAA
