AAAAAAAAAAAAAAA
AB           BA
ABDDCCCCCCC  BA
AB           BA
AB           BA
AB           BA
AB           BA
AB           BA
AAAAAAAAAAAAAAA
